icon-adjust = fa fa-adjust
icon-adn = fa fa-adn
icon-align-center = fa fa-align-center
icon-align-justify = fa fa-align-justify
icon-align-left = fa fa-align-left
icon-align-right = fa fa-align-right
icon-ambulance = fa fa-ambulance
icon-anchor = fa fa-anchor
icon-android = fa fa-android
icon-angle-down = fa fa-angle-down
icon-angle-left = fa fa-angle-left
icon-angle-right = fa fa-angle-right
icon-angle-up = fa fa-angle-up
icon-apple = fa fa-apple
icon-archive = fa fa-archive
icon-arrow-down = fa fa-arrow-down
icon-arrow-left = fa fa-arrow-left
icon-arrow-right = fa fa-arrow-right
icon-arrow-up = fa fa-arrow-up
icon-asterisk = fa fa-asterisk
icon-backward = fa fa-backward
icon-ban-circle = fa fa-ban
icon-bar-chart = fa fa-bar-chart-o
icon-barcode = fa fa-barcode
icon-beaker = fa fa-flask
icon-beer = fa fa-beer
icon-bell-alt = fa fa-bell
icon-bell = fa fa-bell-o
icon-bitbucket-sign = fa fa-bitbucket-square
icon-bitbucket = fa fa-bitbucket
icon-bitcoin = fa fa-bitcoin
icon-bold = fa fa-bold
icon-bolt = fa fa-bolt
icon-book = fa fa-book
icon-bookmark-empty = fa fa-bookmark-o
icon-bookmark = fa fa-bookmark
icon-briefcase = fa fa-briefcase
icon-btc = fa fa-btc
icon-bug = fa fa-bug
icon-building = fa fa-building-o
icon-bullhorn = fa fa-bullhorn
icon-bullseye = fa fa-bullseye
icon-calendar-empty = fa fa-calendar-o
icon-calendar = fa fa-calendar
icon-camera-retro = fa fa-camera-retro
icon-camera = fa fa-camera
icon-caret-down = fa fa-caret-down
icon-caret-left = fa fa-caret-left
icon-caret-right = fa fa-caret-right
icon-caret-up = fa fa-caret-up
icon-certificate = fa fa-certificate
icon-check-empty = fa fa-square-o
icon-check-minus = fa fa-minus-square-o
icon-check-sign = fa fa-check-square
icon-check = fa fa-check-square-o
icon-chevron-down = fa fa-chevron-down
icon-chevron-left = fa fa-chevron-left
icon-chevron-right = fa fa-chevron-right
icon-chevron-sign-down = fa fa-chevron-circle-down
icon-chevron-sign-left = fa fa-chevron-circle-left
icon-chevron-sign-right = fa fa-chevron-circle-right
icon-chevron-sign-up = fa fa-chevron-circle-up
icon-chevron-up = fa fa-chevron-up
icon-circle-arrow-down = fa fa-arrow-circle-down
icon-circle-arrow-left = fa fa-arrow-circle-left
icon-circle-arrow-right = fa fa-arrow-circle-right
icon-circle-arrow-up = fa fa-arrow-circle-up
icon-circle-blank = fa fa-circle-o
icon-circle = fa fa-circle
icon-cloud-download = fa fa-cloud-download
icon-cloud-upload = fa fa-cloud-upload
icon-cloud = fa fa-cloud
icon-cny = fa fa-rub
icon-code-fork = fa fa-code-fork
icon-code = fa fa-code
icon-coffee = fa fa-coffee
icon-cog = fa fa-cog
icon-cogs = fa fa-cogs
icon-collapse-alt = fa fa-minus-square-o
icon-collapse-top = fa fa-caret-square-o-up
icon-collapse = fa fa-caret-square-o-down
icon-columns = fa fa-columns
icon-comment-alt = fa fa-comment-o
icon-comment = fa fa-comment
icon-comments-alt = fa fa-comments-o
icon-comments = fa fa-comments
icon-compass = fa fa-compass
icon-copy = fa fa-files-o
icon-credit-card = fa fa-credit-card
icon-crop = fa fa-crop
icon-css3 = fa fa-css3
icon-cut = fa fa-scissors
icon-dashboard = fa fa-tachometer
icon-desktop = fa fa-desktop
icon-dollar = fa fa-dollar
icon-double-angle-down = fa fa-angle-double-down
icon-double-angle-left = fa fa-angle-double-left
icon-double-angle-right = fa fa-angle-double-right
icon-double-angle-up = fa fa-angle-double-up
icon-download-alt = fa fa-download
icon-download = fa fa-arrow-circle-o-down
icon-dribbble = fa fa-dribbble
icon-dropbox = fa fa-dropbox
icon-edit-sign = fa fa-pencil-square
icon-edit = fa fa-pencil-square-o
icon-eject = fa fa-eject
icon-ellipsis-horizontal = fa fa-ellipsis-h
icon-ellipsis-vertical = fa fa-ellipsis-v
icon-envelope-alt = fa fa-envelope-o
icon-envelope = fa fa-envelope
icon-eraser = fa fa-eraser
icon-eur = fa fa-eur
icon-euro = fa fa-euro
icon-exchange = fa fa-exchange
icon-exclamation-sign = fa fa-exclamation-circle
icon-exclamation = fa fa-exclamation
icon-expand-alt = fa fa-plus-square-o
icon-expand = fa fa-caret-square-o-right
icon-external-link-sign = fa fa-external-link-square
icon-external-link = fa fa-external-link
icon-eye-close = fa fa-eye-slash
icon-eye-open = fa fa-eye
icon-facebook-sign = fa fa-facebook-square
icon-facebook = fa fa-facebook
icon-facetime-video = fa fa-video-camera
icon-fast-backward = fa fa-fast-backward
icon-fast-forward = fa fa-fast-forward
icon-female = fa fa-female
icon-fighter-jet = fa fa-fighter-jet
icon-file-alt = fa fa-file-o
icon-file-text-alt = fa fa-file-text-o
icon-file-text = fa fa-file-text
icon-file = fa fa-file
icon-film = fa fa-film
icon-filter = fa fa-filter
icon-fire-extinguisher = fa fa-fire-extinguisher
icon-fire = fa fa-fire
icon-fixed-width = fa fa-fixed-width
icon-fixed-width = fa fa-fw
icon-flag-alt = fa fa-flag-o
icon-flag-checkered = fa fa-flag-checkered
icon-flag = fa fa-flag
icon-flickr = fa fa-flickr
icon-folder-close-alt = fa fa-folder-o
icon-folder-close = fa fa-folder
icon-folder-open-alt = fa fa-folder-open-o
icon-folder-open = fa fa-folder-open
icon-font = fa fa-font
icon-food = fa fa-cutlery
icon-forward = fa fa-forward
icon-foursquare = fa fa-foursquare
icon-frown = fa fa-frown-o
icon-fullscreen = fa fa-arrows-alt
icon-gamepad = fa fa-gamepad
icon-gbp = fa fa-gbp
icon-gear = fa fa-gear
icon-gears = fa fa-gears
icon-gift = fa fa-gift
icon-github-alt = fa fa-github-alt
icon-github-sign = fa fa-github-square
icon-github = fa fa-github
icon-gittip = fa fa-gittip
icon-glass = fa fa-glass
icon-globe = fa fa-globe
icon-google-plus-sign = fa fa-google-plus-square
icon-google-plus = fa fa-google-plus
icon-group = fa fa-users
icon-h-sign = fa fa-h-square
icon-hand-down = fa fa-hand-o-down
icon-hand-left = fa fa-hand-o-left
icon-hand-right = fa fa-hand-o-right
icon-hand-up = fa fa-hand-o-up
icon-hdd = fa fa-hdd-o
icon-headphones = fa fa-headphones
icon-heart-empty = fa fa-heart-o
icon-heart = fa fa-heart
icon-home = fa fa-home
icon-hospital = fa fa-hospital-o
icon-html5 = fa fa-html5
icon-inbox = fa fa-inbox
icon-indent-left = fa fa-outdent
icon-indent-right = fa fa-indent
icon-info-sign = fa fa-info-circle
icon-info = fa fa-info
icon-inr = fa fa-inr
icon-instagram = fa fa-instagram
icon-italic = fa fa-italic
icon-jpy = fa fa-jpy
icon-key = fa fa-key
icon-keyboard = fa fa-keyboard-o
icon-krw = fa fa-krw
icon-laptop = fa fa-laptop
icon-large = fa fa-large
icon-large = fa fa-lg
icon-leaf = fa fa-leaf
icon-legal = fa fa-gavel
icon-lemon = fa fa-lemon-o
icon-level-down = fa fa-level-down
icon-level-up = fa fa-level-up
icon-li = fa fa-li
icon-lightbulb = fa fa-lightbulb-o
icon-link = fa fa-link
icon-linkedin-sign = fa fa-linkedin-square
icon-linkedin = fa fa-linkedin
icon-linux = fa fa-linux
icon-list-alt = fa fa-list-alt
icon-list-ol = fa fa-list-ol
icon-list-ul = fa fa-list-ul
icon-list = fa fa-list
icon-location-arrow = fa fa-location-arrow
icon-lock = fa fa-lock
icon-long-arrow-down = fa fa-long-arrow-down
icon-long-arrow-left = fa fa-long-arrow-left
icon-long-arrow-right = fa fa-long-arrow-right
icon-long-arrow-up = fa fa-long-arrow-up
icon-magic = fa fa-magic
icon-magnet = fa fa-magnet
icon-mail-forward = fa fa-mail-forward
icon-mail-reply-all = fa fa-mail-reply-all
icon-mail-reply = fa fa-mail-reply
icon-male = fa fa-male
icon-map-marker = fa fa-map-marker
icon-maxcdn = fa fa-maxcdn
icon-medkit = fa fa-medkit
icon-meh = fa fa-meh-o
icon-microphone-off = fa fa-microphone-slash
icon-microphone = fa fa-microphone
icon-minus-sign-alt = fa fa-minus-square
icon-minus-sign = fa fa-minus-circle
icon-minus = fa fa-minus
icon-mobile-phone = fa fa-mobile
icon-money = fa fa-money
icon-moon = fa fa-moon-o
icon-move = fa fa-arrows
icon-music = fa fa-music
icon-off = fa fa-power-off
icon-ok-circle = fa fa-check-circle-o
icon-ok-sign = fa fa-check-circle
icon-ok = fa fa-check
icon-paper-clip = fa fa-paperclip
icon-paperclip = fa fa-paperclip
icon-paste = fa fa-clipboard
icon-pause = fa fa-pause
icon-pencil = fa fa-pencil
icon-phone-sign = fa fa-phone-square
icon-phone = fa fa-phone
icon-picture = fa fa-picture-o
icon-pinterest-sign = fa fa-pinterest-square
icon-pinterest = fa fa-pinterest
icon-plane = fa fa-plane
icon-play-circle = fa fa-play-circle-o
icon-play-sign = fa fa-play-circle
icon-play = fa fa-play
icon-plus-sign-alt = fa fa-plus-square
icon-plus-sign = fa fa-plus-circle
icon-plus = fa fa-plus
icon-power-off = fa fa-power-off
icon-print = fa fa-print
icon-pushpin = fa fa-thumb-tack
icon-puzzle-piece = fa fa-puzzle-piece
icon-qrcode = fa fa-qrcode
icon-question-sign = fa fa-question-circle
icon-question = fa fa-question
icon-quote-left = fa fa-quote-left
icon-quote-right = fa fa-quote-right
icon-random = fa fa-random
icon-refresh = fa fa-refresh
icon-remove-circle = fa fa-times-circle-o
icon-remove-sign = fa fa-times-circle
icon-remove = fa fa-times
icon-renminbi = fa fa-renminbi
icon-renren = fa fa-renren
icon-reorder = fa fa-bars
icon-repeat = fa fa-repeat
icon-reply-all = fa fa-reply-all
icon-reply = fa fa-reply
icon-resize-full = fa fa-expand
icon-resize-horizontal = fa fa-arrows-h
icon-resize-small = fa fa-compress
icon-resize-vertical = fa fa-arrows-v
icon-retweet = fa fa-retweet
icon-road = fa fa-road
icon-rocket = fa fa-rocket
icon-rotate-left = fa fa-rotate-left
icon-rotate-right = fa fa-rotate-right
icon-rss-sign = fa fa-rss-square
icon-rss = fa fa-rss
icon-rupee = fa fa-rupee
icon-save = fa fa-floppy-o
icon-screenshot = fa fa-crosshairs
icon-search = fa fa-search
icon-share-alt = fa fa-share
icon-share-sign = fa fa-share-square
icon-share = fa fa-share-square-o
icon-shield = fa fa-shield
icon-shopping-cart = fa fa-shopping-cart
icon-sign-blank = fa fa-square
icon-signal = fa fa-signal
icon-signin = fa fa-sign-in
icon-signout = fa fa-sign-out
icon-sitemap = fa fa-sitemap
icon-skype = fa fa-skype
icon-smile = fa fa-smile-o
icon-sort-by-alphabet-alt = fa fa-sort-alpha-desc
icon-sort-by-alphabet = fa fa-sort-alpha-asc
icon-sort-by-attributes-alt = fa fa-sort-amount-desc
icon-sort-by-attributes = fa fa-sort-amount-asc
icon-sort-by-order-alt = fa fa-sort-numeric-desc
icon-sort-by-order = fa fa-sort-numeric-asc
icon-sort-down = fa fa-sort-asc
icon-sort-down = fa fa-sort-desc
icon-sort-up = fa fa-sort-asc
icon-sort-up = fa fa-sort-desc
icon-sort = fa fa-sort
icon-spin = fa fa-spin
icon-spinner = fa fa-spinner
icon-stackexchange = fa fa-stack-overflow
icon-star-empty = fa fa-star-o
icon-star-half-empty = fa fa-star-half-o
icon-star-half-full = fa fa-star-half-full
icon-star-half = fa fa-star-half
icon-star = fa fa-star
icon-step-backward = fa fa-step-backward
icon-step-forward = fa fa-step-forward
icon-stethoscope = fa fa-stethoscope
icon-stop = fa fa-stop
icon-strikethrough = fa fa-strikethrough
icon-subscript = fa fa-subscript
icon-suitcase = fa fa-suitcase
icon-sun = fa fa-sun-o
icon-superscript = fa fa-superscript
icon-table = fa fa-table
icon-tablet = fa fa-tablet
icon-tag = fa fa-tag
icon-tags = fa fa-tags
icon-tasks = fa fa-tasks
icon-terminal = fa fa-terminal
icon-text-height = fa fa-text-height
icon-text-width = fa fa-text-width
icon-th-large = fa fa-th-large
icon-th-list = fa fa-th-list
icon-th = fa fa-th
icon-thumbs-down-alt = fa fa-thumbs-o-down
icon-thumbs-down = fa fa-thumbs-down
icon-thumbs-up-alt = fa fa-thumbs-o-up
icon-thumbs-up = fa fa-thumbs-up
icon-ticket = fa fa-ticket
icon-time = fa fa-clock-o
icon-tint = fa fa-tint
icon-trash = fa fa-trash-o
icon-trello = fa fa-trello
icon-trophy = fa fa-trophy
icon-truck = fa fa-truck
icon-tumblr-sign = fa fa-tumblr-square
icon-tumblr = fa fa-tumblr
icon-twitter-sign = fa fa-twitter-square
icon-twitter = fa fa-twitter
icon-umbrella = fa fa-umbrella
icon-unchecked = fa fa-unchecked
icon-underline = fa fa-underline
icon-undo = fa fa-undo
icon-unlink = fa fa-chain-broken
icon-unlock-alt = fa fa-unlock-alt
icon-unlock = fa fa-unlock
icon-upload-alt = fa fa-upload
icon-upload = fa fa-arrow-circle-o-up
icon-usd = fa fa-usd
icon-user-md = fa fa-user-md
icon-user = fa fa-user
icon-vk = fa fa-vk
icon-volume-down = fa fa-volume-down
icon-volume-off = fa fa-volume-off
icon-volume-up = fa fa-volume-up
icon-warning-sign = fa fa-exclamation-triangle
icon-weibo = fa fa-weibo
icon-windows = fa fa-windows
icon-won = fa fa-won
icon-wrench = fa fa-wrench
icon-xing-sign = fa fa-xing-square
icon-xing = fa fa-xing
icon-yen = fa fa-yen
icon-youtube-play = fa fa-youtube-play
icon-youtube-sign = fa fa-youtube-square
icon-youtube = fa fa-youtube
icon-zoom-in = fa fa-search-plus
icon-zoom-out = fa fa-search-minus
icons-ul = fa fa-ul
